 1  1  1  1  1  1  1  1  1  1  1  1  1  1  1  1  1  1  1  1  1  1  1  1  1  1  1  1  1  1  1  1  1  1  1  1  1  1  1  1  1  1  1  1  1  1  1  1  1  1  1  1  1  1  1  1  1  1  1  1  1  1  1  1  1  1  1  1  1  1  1  1  1  1  1  1  1  1  1  1  1  1  1  1  1  1  1  1  1  1  1  1  1  1  1  1  1  1  1  1  1  1  1  1  1  1  1  1  1  1  1  1  1  1  1  1  1  1  1  1  1  1  1  1  1  1  1  1  1  1  1  1  1  1  1  1  1  1  1  1  1  1  1  1  1  1  1  1  1  1  1  1  1  1  1  1  1  1  1  1
 1  1  1  1  1  1  1  1  1  1  1  1  1  1  1  1  1  1  1  1  1  1  1  1  1  1  1  1  1  1  1  1  1  1  1  1  1  1  1  1  1  1  1  1  1  1  1  1  1  1  1  1  1  1  1  1  1  1  1  1  1  1  1  1  1  1  1  1  1  1  1  1  1  1  1  1  1  1  1  1  1  1  1  1  1  1  1  1  1  1  1  1  1  1  1  1  1  1  1  1  1  1  1  1  1  1  1  1  1  1  1  1  1  1  1  1  1  1  1  1  1  1  1  1  1  1  1  1  1  1  1  1  1  1  1  1  1  1  1  1  1  1  1  1  1  1  1  1  1  1  1  1  1  1  1  1  1  1  1  1
 1  1  1  1  1  1  1  1  1  1  1  1  1  1  1  1  1  1  1  1  1  1  1  1  1  1  1  1  1  1  1  1  1  1  1  1  1  1  1  1  1  1  1  1  1  1  1  1  1  1  1  1  1  1  1  1  1  1  1  1  1  1  1  1  1  1  1  1  1  1  1  1  1  1  1  1  1  1  1  1  1  1  1  1  1  1  1  1  1  1  1  1  1  1  1  1  1  1  1  1  1  1  1  1  1  1  1  1  1  1  1  1  1  1  1  1  1  1  1  1  1  1  1  1  1  1  1  1  1  1  1  1  1  1  1  1  1  1  1  1  1  1  1  1  1  1  1  1  1  1  1  1  1  1  1  1  1  1  1  1
 1  1  1  1  1  1  1  1  1  1  1  1  1  1  1  1  1  1  1  1  1  1  1  1  1  1  1  1  1  1  1  1  1  1  1  1  1  1  1  1  1  1  1  1  1  1  1  1  1  1  1  1  1  1  1  1  1  1  1  1  1  1  1  1  1  1  1  1  1  1  1  1  1  1  1  1  1  1  1  1  1  1  1  1  1  1  1  1  1  1  1  1  1  1  1  1  1  1  1  1  1  1  1  1  1  1  1  1  1  1  1  1  1  1  1  1  1  1  1  1  1  1  1  1  1  1  1  1  1  1  1  1  1  1  1  1  1  1  1  1  1  1  1  1  1  1  1  1  1  1  1  1  1  1  1  1  1  1  1  1
 1  1  1  1  1  1  1  1  1  1  1  1  1  1  1  1  1  1  1  1  1  1  1  1  1  1  1  1  1  1  1  1  1  1  1  1  1  1  1  1  1  1  1  1  1  1  1  1  1  1  1  1  1  1  1  1  1  1  1  1  1  1  1  1  1  1  1  1  1  1  1  1  1  1  1  1  1  1  1  1  1  1  1  1  1  1  1  1  1  1  1  1  1  1  1  1  1  1  1  1  1  1  1  1  1  1  1  1  1  1  1  1  1  1  1  1  1  1  1  1  1  1  1  1  1  1  1  1  1  1  1  1  1  1  1  1  1  1  1  1  1  1  1  1  1  1  1  1  1  1  1  1  1  1  1  1  1  1  1  1
 1  1  1  1  1  1  1  1  1  1  1  1  1  1  1  1  1  1  1  1  1  1  1  1  1  1  1  1  1  1  1  1  1  1  1  1  1  1  1  1  1  1 640 641 642 643 644 645 641 642 642 643 645 641 658 641 671 672  1  1  1  1  1  1  1  1  1  1  1  1  1  1  1  1  1  1  1  1  1  1  1  1  1  1  1  1  1  1  1  1  1  1  1  1  1  1  1  1  1  1  1  1  1  1  1  1  1  1  1  1  1  1  1  1  1  1  1  1  1  1  1  1  1  1  1  1  1  1  1  1  1  1  1 640 641 642 643 644 645 670 671 672  1  1  1  1  1  1  1  1  1  1  1  1  1  1  1  1  1  1
 1  1  1  1  1  1  1  1  1  1  1  1  1  1  1  1  1  1  1  1  1  1  1  1  1  1  1  1  1  1  1  1  1  1  1  1  1  1  1  1  1  1 698  1  1  1  1  1  1  1  1  1  1  1  1  1  1 730  1  1  1  1  1  1  1  1  1  1  1  1  1  1  1  1  1  1  1  1  1  1  1  1  1  1  1  1  1  1  1  1  1  1  1  1  1  1  1  1  1  1  1  1  1  1  1  1  1  1  1  1  1  1  1  1  1  1  1  1  1  1  1  1  1  1  1  1  1  1  1  1  1  1  1 698  1  1  1  1  1  1  1 730  1  1  1  1  1  1  1  1  1  1  1  1  1  1  1  1  1  1
 1  1  1  1  1  1  1  1  1  1  1  1  1  1  1  1  1  1  1  1  1  1  1  1  1  1  1  1  1  1  1  1  1  1  1  1  1  1  1  1  1  1 814  1  1  1  1  1  1  1  1  1  1  1  1  1  1 788  1  1  1  1  1  1  1  1  1  1  1  1  1  1  1  1  1  1  1  1  1  1  1  1  1  1  1  1  1  1  1  1  1  1  1  1  1  1  1  1  1  1  1  1  1  1  1  1  1  1  1  1  1  1  1  1  1  1  1  1  1  1  1  1  1  1  1  1  1  1  1  1  1  1  1 756  1  1  1  1  1  1  1 788  1  1  1  1  1  1  1  1  1  1  1  1  1  1  1  1  1  1
 1 186 187  1  1  1  1  1  1  1  1  1  1  1  1  1  1  1  1  1  1  1  1  1  1  1  1  1  1  1  1 466 466 466 466 466 466 466 466 466 466 466 872 466 466 466 466  1  1  1  1  1  1  1  1  1  1 846  1  1  1  1  1  1  1  1  1  1  1  1  1  1  1  1  1  1  1  1  1  1  1  1  1  1  1  1  1  1  1  1  1  1  1  1  1  1  1  1  1  1  1  1  1  1  1  1  1  1  1  1  1  1  1  1  1  1  1  1  1  1 186 187 188 189 190 191 192 193  1  1  1  1  1 814  1  1  1  1  1  1  1 846  1  1  1  1  1  1  1  1  1  1  1  1  1  1  1  1  1  1
 1  1  1  1  1  1  1  1  1  1  1  1  1  1  1  1  1  1  1  1  1  1  1  1  1  1  1  1  1  1  1  1  1  1  1  1 640 641 642 643 644 645 814  1  1  1  1  1  1  1  1  1  1  1  1  1  1 904 641 642 643 645 672  1  1  1  1  1  1  1  1  1  1  1  1  1  1  1  1  1  1  1  1  1  1  1  1  1  1  1  1  1  1  1  1  1  1  1  1  1  1  1  1  1  1  1  1  1  1  1  1  1  1  1  1  1  1  1  1  1 244 245 246 247 248 249 250 251 640 641 642 642 651 872  1  1  1  1  1  1  1 904  1  1  1 136 137 138 139 141 143 144 145 146  1  1  1  1  1  1
 1  1  1  1  1  1  1  1  1  1  1  1  1  1  1  1  1  1  1  1  1  1  1  1  1  1  1  1  1  1  1 409 410 411 466 466 698 466  1  1  1  1  1  1  1  1  1  1  1  1  1  1  1  1  1  1  1  1  1  1  1  1 730  1  1  1  1  1  1  1  1  1  1  1  1  1  1  1  1  1  1  1  1  1  1  1  1  1  1  1  1  1  1  1  1  1  1  1  1  1  1  1  1  1  1  1  1  1  1  1  1  1  1  1  1  1  1  1  1  1 302 303 304 305 306 307 308 309 698  1  1  1  1  1  1  1  1  1  1  1  1 962  1  1  1  1  1  1  1  1  1  1  1  1  1  1  1  1  1  1
 1  1  1  1  1  1  1  1  1  1  1  1  1  1  1  1  1  1  1  1 176 60 61 62 63 64 65 66  1  1  1  1 466  1  1  1 756  1  1  1  1  1  1  1  1  1  1  1  1  1  1  1  1  1  1  1  1  1  1  1  1  1 788  1  1  1  1  1  1  1  1  1  1  1  1  1  1  1  1  1  1  1  1  1  1  1  1  1  1  1  1  1  1  1  1  1 60 61 62 63 64 65 66  1  1  1  1  1  1  1  1  1  1  1  1  1  1  1  1  1 360 361 362 363 364 365 366 367 756  1  1  1  1  1  1  1  1  1  1  1  1 1073742786  1  1  1  1  1  1  1  1  1  1  1  1  1  1  1  1  1  1
 1  1  1  1  1  1  1  1 425  1 640 641 642 643 644 670 670 671 672  1  1 118  1  1  1  1  1 124  1  1  1  1  1  1  1  1 814  1  1  1  1  1  1  1  1  1  1  1  1  1  1  1  1  1  1  1  1  1  1  1  1  1 846  1  1  1  1  1  1  1  1  1  1  1  1  1  1  1  1  1  1  1  1  1  1  1  1  1  1  1  1  1  1  1  1  1 118  1  1  1  1  1 124  1  1  1  1  1  1  1  1  1  1  1  1  1  1  1  1  1 418 419 420 421 422 423 424 425 814  1  1  1  1  1  1  1  1  1  1  1  1 1073742728  1  1  1  1  1  1  1  1  1  1  1  1  1  1  1  1  1  1
 1 12  1 478  1  1 481 482 483  1 698  1  1  1  1  1  1  1 730  1  1  1  1  1  1  1  1 182  1  1  1  1  1  1  1  1 872  1  1  1  1  1  1  1  1  1  1  1  1  1  1  1  1  1  1  1  1  1  1  1  1  1 904  1  1  1  1  1  1  1  1  1  1  1  1  1  1  1  1  1  1  1  1  1  1  1  1  1  1  1  1  1  1  1  1  1  1  1 396  1  1  1 182  1  1  1  1  1  1  1  1  1  1  1  1  1  1  1  1  1 476 477 478 479 480 481 482 483 872  1  1  1  1  1  1  1  1  1  1  1  1 1073742670  1  1  1  1  1  1  1  1  1  1  1  1  1  1  1  1  1  1
641 44 641 651 641 642 658 651 541  1 756  1  1  1  1  1  1  1 788  1  1  1  1  1  1  1  1  1  1  1  1  1  1  1  1  1 930  1  1  1  1  1  1  1  1  1  1  1  1  1  1  1  1  1  1  1  1  1  1  1  1  1 962 642 643 650 651 652 641 642 643 654 655 642 644 645 672  1  1  1  1  1  1  1  1 640 641 642 643 644 645 641 670 671 672  1  1  1 221 222 335  1073741545  1  1  1 211 212 213 212 213 214  1  1  1 640 641 642 643 654 655 650 651 641 642 538 -2147483005 -2147483006 -2147483007 930  1  1  1  1  1  1  1  1  1  1  1  1 846  1  1  1  1  1  1  1  1  1  1  1  1  1  1  1  1  1  1
 1  1  1  1  1  1  1  1 730  1 814  1  1  1  1  1  1  1 846  1  1  1  1  1  1  1  1  1  1  1  1  1  1  1  1  1 988  1  1  1  1  1  1  1  1  1  1  1  1  1  1  1  1  1  1  1  1  1  1  1  1  1  1  1  1  1  1  1  1  1  1  1  1  1  1  1 730  1  1  1  1  1  1  1  1 698  1  1  1  1  1  1  1  1 730  1  1  1 1073742045 397 1038  1073741603  1  1  1  1  1  1  1  1  1  1  1  1 698  1  1  1  1  1  1  1  1  1  1  1  1  1  1  1  1  1  1  1  1  1  1  1  1  1  1 904  1  1  1  1  1  1  1  1  1  1  1  1  1  1  1  1  1  1
 1  1  1  1  1  1  1  1 788  1 872  1  1  1  1  1  1  1 904  1  1  1  1  1  1  1  1  1  1  1  1  1  1  1  1  1 814  1  1  1  1  1  1  1  1  1  1  1  1  1  1  1  1  1  1  1  1  1  1  1  1  1  1  1  1  1  1  1  1  1  1  1  1  1  1  1 788  1  1  1  1  1  1  1  1 756  1  1  1  1  1  1  1  1 788  1  1  1 221 222 1038 575 576 577  1 1073742045 570 226 227  1  1  1  1  1 756  1  1  1  1  1  1  1  1  1  1  1  1  1  1  1  1  1  1  1  1  1  1  1  1  1  1 962  1  1  1  1  1  1  1  1  1  1  1  1  1  1  1  1  1  1
 1  1  1  1  1  1  1  1 846  1 930  1  1  1  1  1  1  1 962  1  1  1  1  1  1  1  1  1  1  1  1  1  1  1  1  1 988  1  1  1  1  1  1  1  1  1  1  1  1  1  1  1  1  1  1  1  1  1  1  1  1  1  1  1  1  1  1  1  1  1  1  1  1  1  1  1 846  1  1  1  1  1  1  1  1 814  1  1  1  1  1  1  1  1 846  1  1  1 279 280 397 633 634 635 626 627 628 284 285  1  1  1  1  1 814  1  1  1  1  1  1  1  1  1  1  1  1  1  1  1  1  1  1  1  1  1  1  1  1  1  1 846  1  1  1  1  1  1  1  1  1  1  1  1  1  1  1  1  1  1
 1  1  1  1  1  1  1  1 904  1 988  1  1  1  1  1  1  1 846  1  1  1  1  1  1  1  1  1  1  1  1  1  1  1  1  1 930  1  1  1  1  1  1  1  1  1  1  1  1  1  1  1  1  1  1  1  1  1  1  1  1  1  1  1  1  1  1  1  1  1  1  1  1  1  1  1 904  1  1  1  1  1  1  1  1 872  1  1  1  1  1  1  1  1 904  1  1 568 569 570 748 450 451 1093 1094 628 748 575 576 577  1  1  1  1 872  1  1  1  1  1  1  1  1  1  1  1  1  1  1  1  1  1  1  1  1  1  1  1  1  1  1 904  1  1  1  1  1  1  1  1  1  1  1  1  1  1  1  1  1  1
 1  1  1  1  1  1  1  1 962  1 930  1  1  1  1  1  1  1 904  1  1  1  1  1  1  1  1  1  1  1  1  1  1  1  1  1 814  1  1  1  1  1  1  1  1  1  1  1  1  1  1  1  1  1  1  1  1  1  1  1  1  1  1  1  1  1  1  1  1  1  1  1  1  1  1  1 962  1  1  1  1  1  1  1  1 930  1  1  1  1  1  1  1  1 962  1  1 626 627 628 748 508 509 748 743 743 743 633 634 635  1  1  1  1 930  1  1  1  1  1  1  1  1  1  1  1  1  1  1  1  1  1  1  1  1  1  1  1  1  1  1 962  1  1  1  1  1  1  1  1  1  1  1  1  1  1  1  1  1  1
