 3  3  3  3  3  3  3  3  3  3  3  3  3  3  3  3  3  3  3  3  3  3  3  3  3  3  3  3  3  3  3  3  3  3  3  3  3  3  3  3
 3  3  3  3  3  3  3  3  3  3  3  3  3  3  3  3  3  3  3  3  3  3  3  3  3  3  3  3  3  3  3  3  3  3  3  3  3  3  3  3
 3  3  3  3  3  3  3  3  3  3  3  3  3  3  3  3  3  3  3  3  3  3  3  3  3  3  3  3  3  3  3  3  3  3  3  3  3  3  3  3
 3  3  3  3  3  3  3  3  3  3  3  3  3  3  3  3  3  3  3  3  3  3  3  3  3  3  3  3  3  3  3  3  3  3  3  3  3  3  3  3
 3  3  3  3  3  3  3  3  3  3  3  3  3  3  3  3  3  3  3  3  3  3  3  3  3  3  3  3  3  3  3  3  3  3  3  3  3  3  3  3
 3  3  3  3  3  3  3 193 193 193 193 193  3  3  3  3  3  3  3  3  3  3  3  3  3  3  3  3  3  3  3  3  3  3  3  3  3  3  3  3
 3  3  3  3  3  3  3  3  3  3  3  3  3  3  3  3  3  3  3  3  3  3  3  3  3  3  3  3  3  3  3  3  3  3  3  3  3  3  3  3
 3  3  3  3  3  3  3  3  3  3  3  3  3  3  3  3  3  3 224 225 225 225 225 226  3  3  3  3  3  3  3  3  3  3  3  3  3  3  3  3
 3  3  3  3  3  3  3  3  3  3  3  3  3  3  3  3  3  3  3  3  3  3  3  3  3  3  3  3  3  3  3  3  3  3  3  3  3  3  3  3
225 225 225 225 225 225 225 226  3  3  3  3  3  3  3  3  3  3  3  3  3  3  3  3  3 224 225 225 225 225 226  3  3  3  3  3  3  3  3  3
 3  3  3  3  3  3  3  3  3  3  3  3  3  3  3  3  3  3  3  3  3  3  3  3  3  3  3  3  3  3  3  3  3  3  3  3  3  3  3  3
 3  3  3  3  3  3  3  3  3  3  3  3  3  3  3  3  3  3  3  3  3  3  3  3  3  3  3  3  3  3  3  3  3 0 1 1 1 1 1 1
 3  3  3  3  3  3  3  3  3  3  3  3  3  3  3  3  3  3  3  3  3  3  3  3  3  3  3  3  3  3  3  3  3 180 17 17 17 17 17 17
 3  3  3  3  3  3  3  3  3  3  3 224 193 225 225 225 225 225 226  3  3  3  3  3  3  3  3  3  3  3  3  3  3 136 17 17 17 17 17 17
59 59 59 59 59 59 59 2  3  3  3  3  3  3  3  3  3  3  3  3  3  3  3  3  3  3  3  3 58 59 59 59 59 122 17 17 17 17 17 17
17 17 17 17 17 17 17 18  3  3  3  3  3  3  3  3  3  3  3  3  3  3  3  3  3  3  3  3 164 165 165 165 165 165 165 165 165 165 165 165
17 17 17 17 17 17 17 18  3  3  3  3  3  3  3  3  3  3  3  3  3  3  3  3  3  3  3  3 212 247 247 247 247 247 247 247 247 247 247 247
17 17 17 17 17 17 17 93 1 1 1 1 1 1 1 1 1 1  3  3  3  3 0 1 1 1 1 1 1 1 1 1 1 1 1 1 1 1 1 1
17 17 17 17 17 17 17 17 17 17 17 17 17 17 17 17 17 18  3  3  3  3 16 17 17 17 17 17 17 17 17 17 17 17 17 17 17 17 17 17
33 33 33 33 33 33 33 33 33 33 33 33 33 33 33 33 33 34  3  3  3  3 32 33 33 33 33 33 33 33 33 33 33 33 33 33 33 33 33 33
