 1  1  1  1  1  1  1  1  1  1  1  1  1  1  1  1  1  1  1  1  1  1  1  1  1  1  1  1  1  1  1  1  1  1  1  1  1  1  1  1  1  1  1  1  1  1  1  1  1  1  1  1  1  1  1  1  1  1  1  1  1  1  1  1  1  1  1  1  1  1  1  1  1  1  1  1  1  1  1  1  1  1  1  1  1  1  1  1  1  1  1  1  1  1  1  1  1  1  1  1  1  1  1  1  1  1  1  1  1  1  1  1  1  1  1  1  1  1  1  1  1  1  1  1  1  1  1  1  1  1  1  1  1  1  1  1  1  1  1  1  1  1  1  1  1  1  1  1  1  1  1  1  1  1  1  1  1  1  1  1  1  1  1  1  1  1  1  1  1  1  1  1  1  1  1  1  1  1  1  1  1  1  1  1  1  1  1  1  1  1  1  1  1  1  1  1  1  1  1  1  1  1  1  1  1  1  1  1  1  1  1  1  1  1  1  1  1  1  1  1  1  1  1  1  1  1  1  1  1  1  1  1  1  1  1  1  1  1  1  1
 1  1  1  1  1  1  1  1  1  1  1  1  1  1  1  1  1  1  1  1  1  1  1  1  1  1  1  1  1  1  1  1  1  1  1  1  1  1  1  1  1  1  1  1  1  1  1  1  1  1  1  1  1  1  1  1  1  1  1  1  1  1  1  1  1  1  1  1  1  1  1  1  1  1  1  1  1  1  1  1  1  1  1  1  1  1  1  1  1  1  1  1  1  1  1  1  1  1  1  1  1  1  1  1  1  1  1  1  1  1  1  1  1  1  1  1  1  1  1  1  1  1  1  1  1  1  1  1  1  1  1  1  1  1  1  1  1  1  1  1  1  1  1  1  1  1  1  1  1  1  1  1  1  1  1  1  1  1  1  1  1  1  1  1  1  1  1  1  1  1  1  1  1  1  1  1  1  1  1  1  1  1  1  1  1  1  1  1  1  1  1  1  1  1  1  1  1  1  1  1  1  1  1  1  1  1  1  1  1  1  1  1  1  1  1  1  1  1  1  1  1  1  1  1  1  1  1  1  1  1  1  1  1  1  1  1  1  1  1  1
 1  1  1  1  1  1  1  1  1  1  1  1  1  1  1  1  1  1  1  1  1  1  1  1  1  1  1  1  1  1  1  1  1  1  1  1  1  1  1  1  1  1  1  1  1  1  1  1  1  1  1  1  1  1  1  1  1  1  1  1  1  1  1  1  1  1  1  1  1  1  1  1  1  1  1  1  1  1  1  1  1  1  1  1  1  1  1  1  1  1  1  1  1  1  1  1  1  1  1  1  1  1  1  1  1  1  1  1  1  1  1  1  1  1  1  1  1  1  1  1  1  1  1  1  1  1  1  1  1  1  1  1  1  1  1  1  1  1  1  1  1  1  1  1  1  1  1  1  1  1  1  1  1  1  1  1  1  1  1  1  1  1  1  1  1  1  1  1  1  1  1  1  1  1  1  1  1  1  1  1  1  1  1  1  1  1  1  1  1  1  1  1  1  1  1  1  1  1  1  1  1  1  1  1  1  1  1  1  1  1  1  1  1  1  1  1  1  1  1  1  1  1  1  1  1  1  1  1  1  1  1  1  1  1  1  1  1  1  1  1
 1  1  1  1  1  1  1  1  1  1  1  1  1  1  1  1  1  1  1  1  1  1  1  1  1  1  1  1  1  1  1  1  1  1  1  1  1  1  1  1  1  1  1  1  1  1  1  1  1  1  1  1  1  1  1  1  1  1  1  1  1  1  1  1  1  1  1  1  1  1  1  1  1  1  1  1  1  1  1  1  1  1  1  1  1  1  1  1  1  1  1  1  1  1  1  1  1  1  1  1  1  1  1  1  1  1  1  1  1  1  1  1  1  1  1  1  1  1  1  1  1  1  1  1  1  1  1  1  1  1  1  1  1  1  1  1  1  1  1  1  1  1  1  1  1  1  1  1  1  1  1  1  1  1  1  1  1  1  1  1  1  1  1  1  1  1  1  1  1  1  1  1  1  1  1  1  1  1  1  1  1  1  1  1  1  1  1  1  1  1  1  1  1  1  1  1  1  1  1  1  1  1  1  1  1  1  1  1  1  1  1  1  1  1  1  1  1  1  1  1  1  1  1  1  1  1  1  1  1  1  1  1  1  1  1  1  1  1  1  1
 1  1  1  1  1  1  1  1  1  1  1  1  1  1  1  1  1  1  1  1  1  1  1  1  1  1  1  1  1  1  1  1  1  1  1  1  1  1  1  1  1  1  1  1  1  1  1  1  1  1  1  1  1  1  1  1  1  1  1  1  1  1  1  1  1  1  1  1  1  1  1  1  1  1  1  1  1  1  1  1  1  1  1  1  1  1  1  1  1  1  1  1  1  1  1  1  1  1  1  1  1  1  1  1  1  1  1  1  1  1  1  1  1  1  1  1  1  1  1  1  1  1  1  1  1  1  1  1  1  1  1  1  1  1  1  1  1  1  1  1  1  1  1  1  1  1  1  1  1  1  1  1  1  1  1  1  1  1  1  1  1  1  1  1  1  1  1  1  1  1  1  1  1  1  1  1  1  1  1  1  1  1  1  1  1  1  1  1  1  1  1  1  1  1  1  1  1  1  1  1  1  1  1  1  1  1  1  1  1  1  1  1  1  1  1  1  1  1  1  1  1  1  1  1  1  1  1  1  1  1  1  1  1  1  1  1  1  1  1  1
 1  1  1  1  1  1  1  1  1  1  1  1  1  1  1  1  1  1  1  1  1  1  1  1  1  1  1  1  1  1  1  1  1  1  1  1  1  1  1  1  1  1  1 699 700 701 702 703 700 701 700 701 700 701 700 701 728 729  1  1  1  1  1  1  1  1  1  1  1  1  1  1  1  1  1  1  1  1  1  1  1  1  1  1  1  1  1  1  1  1  1  1  1  1  1  1  1  1  1  1  1  1  1  1  1  1  1  1  1  1  1  1  1  1  1  1  1  1  1  1  1  1  1  1  1  1  1  1  1  1  1  1  1  1  1  1  1  1  1  1  1  1  1  1  1  1  1  1  1  1  1  1  1  1  1  1  1  1  1  1  1  1  1  1  1  1  1  1  1  1  1  1  1  1  1  1  1  1  1  1  1  1  1  1  1  1  1  1  1  1  1  1  1  1  1  1  1  1  1  1  1  1  1  1  1  1  1  1  1  1  1  1  1  1  1  1  1  1  1  1  1  1  1  1  1  1  1  1  1  1  1  1  1  1  1  1  1  1  1  1
 1  1  1  1  1  1  1  1  1  1  1  1  1  1  1  1  1  1  1  1  1  1  1  1  1  1  1  1  1  1  1  1  1  1  1  1  1  1  1  1  1  1  1 757 758 759 760 761 992 992 992 992 992 992 992 992 786 787  1  1  1  1  1  1  1  1  1  1  1  1  1  1  1  1  1  1  1  1  1  1  1  1  1  1  1  1  1  1  1  1  1  1  1  1  1  1  1  1  1  1  1  1  1  1  1  1  1  1  1  1  1  1  1  1  1  1  1  1  1  1  1  1  1  1  1  1  1  1  1  1  1  1  1  1  1  1  1  1  1  1  1  1  1  1  1  1  1  1  1  1  1  1  1  1  1  1  1  1  1  1  1  1  1  1  1  1  1  1  1  1  1  1  1  1  1  1  1  1  1  1  1  1  1  1  1  1  1  1  1  1  1  1  1  1  1  1  1  1  1  1  1  1  1  1  1  1  1  1  1  1  1  1  1  1  1  1  1  1  1  1  1  1  1  1  1  1  1  1  1  1  1  1  1  1  1  1  1  1  1  1
 1  1  1  1  1  1  1  1  1  1  1  1  1  1  1  1  1  1  1  1  1  1  1  1  1  1  1  1  1  1  1  1  1  1  1  1  1  1  1  1  1  1  1 815 816 817 818 992 992 992 992 992 992 992 992 992 844 845  1  1  1  1  1  1  1  1  1  1  1  1  1  1  1  1  1  1  1  1  1  1  1  1  1  1  1  1  1  1  1  1  1  1  1  1  1  1  1  1  1  1  1  1  1  1  1  1  1  1  1  1  1  1  1  1  1  1  1  1  1  1  1  1  1  1  1  1  1  1  1  1  1  1  1  1  1  1  1  1  1  1  1  1  1  1  1  1  1  1  1  1  1  1  1  1  1  1  1  1  1  1  1  1  1  1  1  1  1  1  1  1  1  1  1  1  1  1  1  1  1  1  1  1  1  1  1  1  1  1  1  1  1  1  1  1  1  1  1  1  1  1  1  1  1  1  1  1  1  1  1  1  1  1  1  1  1  1  1  1  1  1 699 700 701 702 703 699 700 701 708 709 710 699 700 701 703 703 699 700 701 703
 1  1  1  1  1  1  1  1  1  1  1  1  1  1  1  1  1  1  1  1  1  1  1  1  1  1  1  1  1  1  1  1  1  1  1  1  1  1  1  1  1  1  1 873 874 875 876 992 885 886 887 888 992 992 992 992 902 903  1  1  1  1  1  1  1  1  1  1  1  1  1  1  1  1  1  1  1  1  1  1  1  1  1  1  1  1  1  1  1  1  1  1  1  1  1  1  1  1  1  1  1  1  1  1  1  1  1  1  1  1  1  1  1  1  1  1  1  1  1  1  1  1  1  1  1  1  1  1  1  1  1  1  1  1  1  1 467 468 469  1  1  1  1  1  1  1  1  1  1  1  1  1  1 119 120 121 122 123  1  1  1  1  1  1  1  1  1  1  1  1  1  1  1  1  1  1  1  1  1  1  1  1  1  1  1  1  1  1  1  1  1  1  1  1  1  1  1  1  1  1  1  1  1  1  1  1  1  1  1  1  1  1  1  1  1  1  1  1  1  1 757 758 759 760 761 933 933 934 766 767 768 935 935 935 935 935 933 933 934 935
 1  1  1  1  1  1  1  1  1  1  1  1  1  1  1  1  1  1  1  1  1  1  1  1  1  1  1  1  1  1  1  1  1  1  1  1  1 699 700 701 702 703 703 931 932 933 934 935 943 944 945 946 992 992 992 992 960 961  1  1  1  1  1  1  1  1  1  1  1  1  1  1  1  1  1  1  1  1  1  1  1  1  1  1  1  1  1  1  1  1  1  1  1  1  1  1  1  1  1  1  1  1  1  1  1  1  1  1  1  1  1  1  1  1  1  1  1  1 699 699 700 701 703 700 728 729  1  1  1  1 467 468 469  1  1  1 525 526 527  1  1  1  1  1  1  1  1  1  1  1  1  1  1 177 178 179 180 181  1  1  1  1  1  1  1  1  1  1  1  1  1  1  1  1  1  1  1  1  1  1  1  1  1  1  1  1  1  1  1  1  1  1  1  1  1  1  1  1  1  1  1  1  1  1  1  1  1  1  1  1  1  1  1 699 700 701 702 703 699 700 815 816 817 818 819 991 933 934 935 993 993 993 993 993 993 993 991 991 933 934
 1  1  1  1  1  1  1  1  1  1  1  1  1  1  1  1  1  1  1  1  1  1  1  1  1  1  1  1  1  1  1 467 468 469  1  1  1 757 758 759 760 761 761 991 992 993 991 992 992 992 992 992 992 992 882 883 844 845 700 701 700 728 729  1  1  1  1  1  1  1  1  1  1  1  1  1  1  1  1  1  1  1  1  1  1  1  1  1  1  1  1  1  1  1  1  1  1  1  1  1  1  1  1  1  1  1  1  1  1  1  1  1  1  1  1  1  1  1 757 758 933 934 935 761 786 787  1  1  1  1 525 526 527  1  1  1  1  1  1  1  1  1  1  1  1  1  1 467 468 469  1  1  1 235 236 237 238 239  1  1  1  1  1  1  1  1  1  1  1  1  1  1  1  1  1  1  1  1  1  1  1  1  1  1  1  1  1  1  1  1  1  1  1  1  1  1  1  1  1  1  1  1  1  1  1  1  1  1  1  1  1  1  1 757 758 759 760 761 761 761 877 877 877 876 877 933 933 885 886 887 888 933 934 935 935 991 991 933 933 934
 1  1  1  1  1  1  1  1  1  1  1  1  1  1  1  1  1  1  1  1  1 118 119 120 121 122 123 124  1  1  1 525 526 527  1  1  1 815 816 817 818 819 819 991 992 882 883 992 992 992 992 992 992 992 940 941 992 992 933 933 933 786 787  1  1  1  1  1  1  1  1  1  1  1  1  1  1  1  1  1  1  1  1  1  1  1  1  1  1  1  1  1  1  1  1  1  1  1  1  1  1  1  1  1  1  1  1  1  1  1  1  1  1  1  1  1  1  1 815 816 991 992 993 819 844 845  1  1  1  1  1  1  1  1  1  1  1  1  1  1  1 467 468 469  1  1  1 525 526 527  1  1  1  1  1  1  1  1  1  1  1  1  1  1  1  1  1  1  1  1  1  1  1  1  1  1  1  1  1  1  1  1  1  1  1  1  1  1  1  1  1  1  1  1  1  1  1  1  1  1  1  1  1  1  1  1  1  1  1  1  1  1  1 815 816 817 818 819 761 761 935 877 882 883 877 933 933 943 944 945 946 933 934 935 993 934 935 991 933 934
 1  1  1  1  1  1  1  1  1  1  1 699 700 701 702 703 728 729  1  1  1 176 177 178 179 180 181 182  1  1  1  1  1  1  1  1  1 873 874 875 876 877 877 991 992 940 941 992 992 992 992 992 992 992 998 999 992 992 933 933 933 844 845  1  1  1  1  1  1  1  1  1  1  1  1  1  1  1  1  1  1  1  1  1  1  1  1  1  1  1  1  1  1  1  1  1  1  1  1  1  1  1  1  1  1  1  1  1  1  1  1  1  1 699 700 701 702 703 873 874 933 934 935 877 902 903  1  1  1  1  1  1  1  1  1  1  1  1  1  1  1 525 526 527  1  1  1  1  1  1  1  1  1  1  1  1  1  1  1  1  1  1  1  1  1  1  1  1  1  1  1  1  1  1  1  1  1  1  1  1  1 699 700 701 702 703 728 729  1  1  1  1  1  1  1  1  1  1  1  1  1  1  1  1  1  1  1 699 700 701 702 703 703 873 874 875 876 877 761 761 993 877 940 941 933 991 991 933 933 934 933 934 935 935 993 885 886 887 888 934
 1  1  1  1  1  1  1  1  1  1  1 757 758 759 760 761 786 787  1  1  1 234 235 236 237 238 239 240  1  1  1  1  1  1  1  1  1 931 932 933 934 935 935 991 992 998 999 992 992 992 992 992 992 992 1056 1057 992 933 933 933 933 902 903  1  1  1  1  1  1  1  1  1  1  1  1  1  1  1  1  1  1  1  1  1  1  1  1  1  1  1  1  1  1  1  1  1  1  1  1  1  1  1  1  1  1  1  1  1  1  1  1  1  1 757 758 759 760 761 933 934 991 992 993 935 960 961  1  1  1  1  1  1  1  1  1  1  1  1  1  1  1  1  1  1  1  1  1  1  1  1  1  1  1  1  1  1  1  1  1  1  1  1  1  1 699 700 701 702 703 699 700 701 699 700 701 728 729  1  1  1  1 757 758 759 760 761 786 787  1  1  1  1  1  1  1  1  1  1  1  1 467 468 469  1  1  1  1 757 758 759 760 761 761 933 934 935 935 885 886 887 888 877 998 999 933 991 992 991 933 933 934 935 935 993 993 943 944 945 946 934
 1  1  1  1  1  1  1  1  1  1  1 815 816 817 818 819 844 845  1  1  1 292 293 294 295 296 297 298  1  1  1  1  1  1  1  1  1 989 990 991 885 886 887 888 992 1056 1057 992 992 992 882 883 992 992 992 992 885 886 887 888 933 960 961  1  1  1  1  1  1  1  1  1  1  1  1  1  1  1 678 679 678 679 681 682 683  1 674 675 676 678 679 678 679 678 681 682 683  1 674 675 676 678 679 678 679 678 679  1  1  1  1  1  1 815 816 817 818 819 991 992 885 886 887 888 902 903  1  1  1  1  1  1  1  1  1  1  1  1  1  1  1  1  1  1  1  1  1  1  1  1  1  1  1  1  1  1  1  1  1  1  1  1  1  1 757 758 759 760 761 933 934 935 761 761 761 786 787  1  1  1  1 815 816 817 818 819 844 845  1  1  1  1 119 120 121 122 123  1  1  1 525 526 527  1  1  1  1 815 816 817 818 819 819 991 933 934 935 943 944 945 946 935 1056 1057 991 991 992 993 991 933 882 883 935 993 993 993 933 933 934 935
699 700 701 699 700 701 728 729  1  1  1 873 874 875 876 877 902 903  1  1  1  1  1  1  1  1  1  1  1  1  1  1  1  1  1  1  1 931 932 933 943 944 945 946 992 993 991 992 992 992 940 941 882 992 992 992 943 944 945 946 933 844 845 728 700 701 700 701 700 701 700 701 700 701 700 701 728 729 736 737 736 737 739 740 741  1 732 733 734 736 737 736 737 736 739 740 741  1 732 733 734 736 737 736 737 736 737 699 700 701 702 703 699 873 874 875 876 877 933 934 943 944 945 946 844 845  1  1  1  1  1  1  1  1  1  1  1  1  1  1  1  1  1  1  1  1  1  1  1  1  1  1  1  1  1  1  1  1  1  1  1  1  1  1 815 816 817 818 819 991 992 885 886 887 888 844 845  1  1  1  1 873 874 875 876 877 902 903  1  1  1  1 177 178 179 180 181  1  1  1  1  1  1  1  1  1  1 873 874 875 876 877 877 933 933 934 935 819 882 883 877 877 877 877 991 992 993 933 934 935 940 941 935 935 993 992 991 933 934 935
993 993 993 993 993 993 786 787  1  1  1 931 932 882 883 935 960 961  1  1  1  1  1  1  1  1  1  1  1  1  1  1  1  1  1  1  1 989 990 991 992 993 993 991 992 993 991 992 992 882 998 999 882 882 992 992 992 992 933 933 933 882 882 933 933 885 886 887 888 933 933 933 933 933 933 933 786 787 794 795 794 795 797 798 799  1 790 791 792 794 795 794 795 794 797 798 799  1 790 791 792 794 795 794 795 794 795 757 758 759 760 761 1025 882 883 935 933 934 991 992 933 934 935 819 902 903  1  1  1  1  1  1  1  1  1  1  1  1  1  1  1  1  1  1  1  1  1  1  1  1  1  1 699 700 701 702 703 699 700 703 700 699 700 703 873 874 875 876 877 761 882 943 944 945 946 902 903  1  1  1  1 931 932 933 882 883 960 961  1  1  1  1 235 236 237 238 239  1  1  1  1  1  1  1  1  1  1 931 932 933 934 935 935 933 933 934 935 877 940 941 877 877 877 935 885 886 887 888 934 935 998 999 935 993 993 993 991 933 934 935
993 885 886 887 888 993 844 845  1  1  1 989 990 940 941 993 844 845  1  1  1  1  1  1  1  1  1  1  1  1  1  1  1  1  1  1  1 931 932 933 934 935 993 991 992 993 991 992 992 992 1056 1057 882 882 882 992 992 992 933 933 933 882 882 933 933 943 944 945 946 933 933 933 933 933 933 933 844 845  1  1  1  1  1  1  1  1  1  1  1  1  1  1  1  1  1  1  1  1  1  1  1  1  1  1  1  1  1 815 816 817 818 819 1025 940 941 993 991 992 933 934 991 992 993 877 960 961  1  1  1  1  1  1  1  1  1  1  1  1  1  1  1  1  1  1  1  1  1  1  1  1  1  1 757 758 759 760 761 885 886 887 888 761 761 761 933 934 935 933 934 935 940 941 935 761 819 960 961  1  1  1  1 989 990 991 940 941 844 845  1  1  1  1 293 294 295 296 297  1  1  1  1  1  1  1  1  1  1 989 990 991 992 993 885 886 887 888 935 935 998 999 877 877 935 933 943 944 945 946 934 935 1056 1057 933 885 886 887 888 933 933 934
993 943 944 945 946 993 902 903  1  1  1 931 932 998 999 992 902 903  1  1  1  1  1  1  1  1  1  1  1  1  1  1  1  1  1  1  1 989 990 991 992 993 993 991 992 993 991 992 992 992 992 992 992 992 992 992 992 992 933 933 882 882 882 933 933 933 933 933 933 933 933 885 886 887 888 933 902 903  1  1  1  1  1  1  1  1  1  1  1  1  1  1  1  1  1  1  1  1  1  1  1  1  1  1  1  1  1 873 874 875 876 877 1025 998 999 935 933 934 991 992 933 934 935 935 844 845  1  1  1  1  1  1  1  1  1  1  1  1  1  1  1  1  1  1  1  1  1  1  1  1  1  1 815 816 817 818 819 943 944 945 946 819 819 819 991 992 993 991 992 993 998 999 993 819 877 902 903  1  1  1  1 873 874 933 998 999 902 903  1  1  1  1 351 352 353 354 355  1  1  1  1  1  1  1  1  1  1 931 932 933 934 935 943 944 945 946 993 993 1056 1057 935 877 933 991 991 992 993 933 934 935 935 993 933 943 944 945 946 933 934 935
993 993 993 993 993 993 960 961  1  1  1 815 816 1056 1057 992 960 961  1  1  1  1  1  1  1  1  1  1  1  1  1  1  1  1  1  1  1 931 932 933 934 935 993 991 992 993 991 992 992 992 992 992 992 992 992 992 992 992 933 933 933 882 882 933 933 933 933 933 933 933 933 943 944 945 946 933 960 961  1  1  1  1  1  1  1  1  1  1  1  1  1  1  1  1  1  1  1  1  1  1  1  1  1  1  1  1  1 931 932 933 934 935 1025 1056 1057 993 991 992 933 934 991 992 993 993 902 903  1  1  1  1  1  1  1  1  1  1  1  1  1  1  1  1  1  1  1  1  1  1  1  1  1  1 873 874 875 876 877 877 877 877 877 877 877 877 933 934 935 933 934 935 1056 1057 761 877 935 960 961  1  1  1  1 931 932 991 1056 1057 960 961  1  1  1  1  1  1  1  1  1  1  1  1  1  1  1  1  1  1  1 989 990 991 992 993 819 991 992 993 993 993 877 993 993 935 991 991 992 993 993 933 934 935 993 933 991 991 991 992 993 935 935 935
